start,5,1,,,,
goal,0,6,,,,
1,0,0,1,1,1,1
1,0,0,1,1,1,1
1,0,0,1,1,1,1
1,0,0,1,1,1,1
1,1,1,0,1,1,1
1,1,1,1,1,1,1
